Glossary

Age Uchi - Rising Strike
Aite - Opponent
Anatoshi- Trapping
Asagasumi - Chin
Ashi Barai - Leg Sweep
Ashi Sabaki - Leg/Foot Movement Evasion
Ashiko - Foot band with spikes
Bajutsu – Horsemanship
Barai - Sweep
Bisento - Long battlefield halberd
Bo Ryaku - Strategy
Bo Shuriken  -  Throwing Spikes
Bobi No Kamae - Defensive Posture
Bojutsu  –  Stick and Staff Fighting 
Boshi Ken - Thumb strike
Budo - Martial way
Budoka - Student of the martial way
Bujin - Warrior spirit
Bujutsu - Martial arts techniques
Bushi - Warrior
Bushido - Way of the warrior
Butsumetsu  -  The floating ribs at the bottom of the ribcage
Chi- Earth
Chi Mon - Geography
Chi No Kata - Earth Form
Chi Tobi - Earth Leap
Cho Ho - Espionage
Chu - Middle
Chudan no Kamae - Middle Level Posture
Chunin -  Intermediate ninja
Daijodan no Kamae - Great Upper Level Posture
Daisho - Pair of swords
Daito - Large sword
Dakenjutsu -  Striking, kicking, blocking
Dan - Black belt rank
Do - Japanese for way
Do Gaeshi - Turning the Body
Do Giri Hidari - Sideways Figure Number One Cut from the Left
Do Giri Migi - Sideways Figure Number One Cut from the Right
Do Jime  -  Body Choke
Do/Kote Uchi - Strike to the Body/Wrist
Dojo - training hall
Dokkotsu  - Throat
Doko - Angry tiger
Doko No Kamae - Angry Tiger Posture
Domo Arigato Gozaimashita - “Thank you very much”
Dori - To capture or seize
Empi -  Elbow strike
Empi Nage  -  Elbow Throw
Fu - Wind
Fu No Kata - Wind Form
Fudo Ken - Immovable Fist
Fudoshin - Immovable spirit
Fudoza - Immovable seat
Fudoza No Kamae - Immovable Seat Posture
Fudoza Tobi - Immovable Seat Leap
Fukiya - Blowgun
Futari Dori - grappling with two
Gaeshi - Counter attack
Gake - Hook
Ganseki Nage - throwing the big rock 
Ganseki Ori - Breaking a Big Rock
Ganseki Oshi - Pushing a Big Rock
Ganseki Otoshi - Dropping a Big Rock
Garami - Entangle
Gawa - Side
Gedan Nagashi - Lower Level Flow
Gedan no Kamae - Lower Level Posture
Gedan Uke - Low block
Gedan Uke - Lower Level Receiving
Genin -  beginning ninja
Genjutsu - Art of illusion
Geri - Kick
Gi - Martial arts uniform
Go - Five
Godai -  Five elements
Gokui - Secret
Gorin  -  Five Points in Pentagon Pattern Around Navel
Gyaku - reverse
Gyaku - Reverse (can mean direction or footwork)
Gyaku Ippon Seoi Nage  -  Reverse Number One Shoulder Throw
Gyaku Ippon Zeoi Nage  -  Reversed One Arm Back Throw
Gyaku Jime  -  Reverse Choke
Gyaku Juji Jime  -  Reverse Figure Number Ten Position Choke
Gyaku Kesa Bato - Reverse Angle of Monk’s Robes Drawing Cut
Gyaku Kesa Giri Hidari - Reverse Cutting the Angle of the Monk’s robes from the left
Gyaku Kesa Giri Migi - Reverse Cutting the Angle of Monk’s robes from the right
Gyaku Nagare - Reversal Flow
Gyaku waza - Reversal Techniques
Gyakute - One Hand, Cross Side wrist escape
Gyakute - Reverse Hand wrist escape
Ha - Blade edge of the katana
Hachi - Eight
Hadome  -  Cheek
Hai -  Yes
Haibu Yori -  From behind
Hajime -  Begin
Hajutsu -  escaping techniques
Hajutsu Koho - The Eight Techniques and the Nine Ways
Hamon - Temper line on the katana
Han - Half
Hanbo - 3-foot staff
Hanbojutsu - 3-foot staff fighting
Hane Koshi  -  Popping Hip Throw
Hantachi No Kamae - Half Standing Posture
Hanza No Kamae - Half Seated Posture
Happa Ken  -  Eight Leaf Fist
Happo Geri - Kicking in the Eight Directions
Happo keri henka no kote - Eight Way Changing Kicks
Harai Goshi  - Sweeping Hip Throw
Hasso -  Attack
Hasso no Kamae - Eight Apparitions Posture
Heiho - Combat strategy
Heito no Kamae - Being to Overthrow Evil Posture (Rokushaku bo)
Henka -  Variation
Hensojutsu -  Disguise and impersonation
Hi - Blood Gutter on the katana
Hicho - flying bird
Hicho Kaiten - Flying Bird Roll
Hicho No Kamae - Flying Bird Posture
Hicho No Kata - Flying Bird Form
Hidari -  Left
Hidari Tobi - Left Leap
Hiji - Elbow
Hiki -  Pull
Hira - Flat Posture
Hira Ichimonji no Kamae - Flat Figure Number One Posture (Rokushaku bo)
Hira no Kamae  -  Flat Posture
Hishi -  Dried water chestnut caltrops
Hiza Guruma  -  Knee Wheel
Hodoki - escapes
Hojo - Bind, tie up
Hojutsu - Firearm arts
Hoken Juroppo Ken - The Sixteen Hidden/Secret Fists
Hoko No Kamae  -  Encircling Posture
Hon Gyaku - Base Reversal 
Hon Jime  - Base Choke
Horyaku - Strategy
Hoshi  -  Inner Bottom Part of Elbow
Iai - Sword drawing
Ichi- One
Ichimonji - Figure Number One Posture
Ichimonji No Kamae - Figure Number One Posture
Ichimonji No Kata - Figure Number One Form
Igadama -  Iron caltrops
Ihen No Kamae - Changing Posture
Inpo - Hiding
Intonjutsu -  Escape and concealment
Ippon Seoi Nage  -  One Arm Shoulder Throw
Ippon Zeoi Nage – Two Handed Shoulder Throw on Reversed Arm
Iri - Enter
Itami - Pain
Itami Jime  -  Pain Choke
Itami Nage  - Pain Throw
Jakkin  -  Inside the bicep
Jime Waza  -  “Choking” Waza
Jinchu  -  Point just under the nose where it joins the face
Jo- Four-foot staff
Jodan Nagashi - Upper Level Flow
Jodan no Kamae - Upper Level Posture (Rokushaku bo)
Jodan Tsuki - Upper Level Punch
Jodan Uke - Upper Level Receiving, high block
Ju - Ten
Juji Geri - Cross Kick
Juji Nage -  Figure Number Ten Throw
Jumonji - Figure Number Ten Posture
Jumonji No Kamae - Figure Number Ten Posture
Jumonji No Kata - Figure Number Ten Form
Jun Nagashi - Turning Flow
Junan Taiso - Body conditioning
Jutaijutsu - Grappling
Jutsu - Techniques
Ka - Fire
Ka No Kata - Fire Form
Kaeshi- Counter attack
Kagato - Heel Kick From Behind
Kage  -  Bone Above the Solar Plexus
Kagi -  Hook
Kaiten - Rolling breakfalls
Kaiten Ken - Open hand
Kaku  -  Knee
Kakushi Geri - Crescent Kick
Kakusi Geri - Hidden Kick
Kamae - Posture or stance
Kamiza- Shrine
Karuma Gaeshi Nage - Wheel Turn Throw
Karuma Nage  -  Wheel Throw
Kasumi -  Temples of the head
Kasumi no Kamae - Mist Posture
Kata - Set of movements
Kata Yaburi No Kamae - Form Breaking Posture
Katana  -  sword
Katana Giri - Cutting with the Sword
Katana Nuki - Draws with the Sword
Katana- Sword
Katate - One hand
Katate - Wrist escape, One Hand, Same Side
Katate Jime  -  One Handed Choke
Katate Nage  -  One Handed Throw
Kayakujutsu- Fire and explosive arts
Ken Kudaki - Crushing the Fist
Ken Tai Ichi Jo - the body and fist move as one
Kenjutsu - Sword fighting
Keppan -  Blood oath
Keri  - Kicking
Keri kaeshi - Kicking Counters
Keri Kudaki - Crushing the Kick
Kesa Giri Hidari - Cutting the Angle of the Monk’s robes from the Left
Kesa Giri Migi - Cutting the Angle of Monk’s robes from the Right
Ki -  Spirit
Kiai - Focused shout
Kihon Happo - The Eight Basic Ways
Kikaku Ken - Demon Horn Fist
Kiri Age - Rising Cut
Kiri Gasumi  -  Just underneath the earlobe
Kiri Oroshi - Dropping cut
Kissaki - The tip or point area of the sword
Kiten - Flips
Kiten Ken - Turn Causing Fist (Shuto)
Ko Ashi - Small steps
Kobura  - Center of Calf
Kodachi - Small sword
Koe - Hip/leg joint at front of body
Kogagoroshi - Killing the Child (pinkie finger)
Kogoroshi - Finger breaking
Koho - Back
Koho Geri - Backwards Kick
Koho Geri- Back kick
Koho Kaiten - Backward Roll
Koho Tobi - Backward Leap
Koho Ukemi - Backward Breakfall
Kojitsu Tenkan Ho - Philosophy
Koku - Tiger sky
Kokyu - Breath
Koppo Ken - Bone Principle Fist
Koppojutsu - Bone breaking techniques
Koryu - Traditional
Kosei No Kamae - Agressive Posture
Koshi Kihon Sanpo - Three Basic Ways of Striking
Koshi kudaki - Hip Crush
Koshi Nage  -  Hip Throw
Ku - Nine
Ku No Kata - Void Form
Kubi Nage  -  Neck Throw
Kuden - Oral Teachings
Kuji - Nine syllables
Kuji In - Hand posturing
Kujikiri - Protective grid slashing
Kumiuchi - Grappling and close fighting
Kunoichi - Female ninja
Kusari Fundo - Chain with end weights
Kusari Gama - Weighted chain with
Kusarigama - Sickle and Chain Weapon
Kuten - Handsprings
Kuzushi  -  Off-balancing
Kuzushi - Break opponents’ balance
Kyoketsu - Cord and dagger
Kyoketsu Shoge  - chain/rope and sickle weapon
Kyoman - Observation
Kyu - Green belt rank
Kyusho  -  Weakness spots on the body used to inflict pain, distraction, and confusion in the mind of your enemy
Maki -  Winding
Makimono - Scrolls
Matsukaze  -  Adam’s apple
Matte - Wait
Mawashi - Rotate
Mawashi Geri - Round kick
Meijin - Master
Meiso - Meditation
Men Uchi - Strike to the head
Menkyo - Teaching certificate
Menkyo kaiden (免許皆伝) -  Japanese term referring to a certificate of complete transmission, often used in the context of traditional Japanese arts, particularly martial arts, signifying the recipient has mastered all aspects of a particular school or style. 
Metsubishi - Blinding Principles and Applications, also blinding powder
Meysubushi - Distraction
Migi - Right
Migi Tobi - Right Leap
Mizu - Water
Mokuso - Meditate
Morote - Wrist Escape Both Hands
Mune - Back of sword
Munen Muso - No Kamae No Thought No Intention Posture
Murasame  - The divet where the clavicles meet
Musha Dori - Warrior Capture
Musodori - No Thought Capture
Mute - No hands
Muto Dori - unarmed sword defense
Nagare  -  On the forearm, below the elbow where the muscles come together
Nagare - To flow
Nagashi - Flow
Nage - Throw
Nage waza - Throwing Techniques
Naginata – Halberd
Naname - Diagonal
Neko te - Finger tip weapons
Ni - Two
Nin - Endurance or stealth
Ninki -  Specialized ninja tools
Ninpo -  Higher order of Ninjutsu
Noburi Gata - Climbing Natural Objects
Nuki Ashi -  Sweeping step
Nuki Uchi  - Drawing Cut
Obi - Belt
Odashi - Long sword
Omote - Outside
Omote Gyaku  - Outside Reversal
Omote Gyaku Ken Sabaki Gata - Outside Reversal Fist Evasion Form
Omote Kimon  -  Upper pectoral
Omote Takeori - Outward Breaking Bamboo
Onegaishimasu - “Please assist me”
Oni - Devil
Oni Gedeki - Crushing the little devil
Oni Kudaki - Demon Crusher (Omote and Ura)
Ontonashi No Kamae - Soundless Posture
Oogyaku - Great Reversal
Oosoto Guruma  -  Major Outer Wheel
Oosoto Nage - Major Outer Throw
Oshigiri - sword push cut
Osoto Gake - Great outside hook
Oten - Cartwheel
Oyagoroshi - Killing the Parent (thumb)
Randori - Sparring
Rei - Bowing
Reiho - bowing forms
Roku - Six
Ryomune Dori - Two handed chest grab
Ryote - Two Hands
Ryu - School or dragon
Ryumon  -  Above the collar bone where it meets the shoulder
Sageo - Cord for sheath 
Sai – Outer canter muscle bundle of thighs
Sakki - Intuition of attack
Sakui Geri - Scooping Kick
San - Three
San Shin/Gokui - No Kata The Three Hearts Forms
Sankaku Jime  -  Three Pointed Choke
Satori - Enlightenment
Saya - Scabbard/Sheath for the katana
Seigan no Kamae - Correct Eye Posture
Seishin teki kyoyo – Spiritual refinement
Seiza - Kneeling
Seiza No Kamae - Correct Seat Posture
Sempai - Senior student
Senban Shuriken  - Flat throwing blades, especially “Ninja Stars”
Sensei - Teacher
Seoi Nage - Shoulder Throw
Shaken - Throwing stars
Shako Ken - Claw Fist
Shi - Four
Shi Shin Ken  - Finger Needle Fist
Shichi - Seven
Shichibatsu  -  Upper ridge of back hip
Shihan - Senior instructor
Shiho Tenchi Tobi - The Four Ways of Heaven/Earth Leaping
Shikan Ken - Extended Knuckle Fist
Shiken Haramitsu Daikomyo - “Through every encounter, may we be brought to the highest light”
Shikko - Knee Walking
Shikomi Zue - Sword cane
Shin - Heart
Shinai - Bamboo sword
Shinken Gata - Real combat training
Shinken Mutodori Gata - Sword Evasions
Shinobi - Stealth
Shinobi Aruki - Silent Walking
Shinobi Iri  -  Infiltration
Shinpi - Mysticism
Shishin Ken - Finger needle strike
Shitan Ken - Finger Tip Fist
Shito Ken - Finger Sword Fist (Boshi Ken)
Shizen Ken - Natural body weapon
Shizen No Kamae - Natural Posture
Shomen - Front
Shomen Uchi - Strike to the Crown
Shoten No Jutsu - Ascending to the Heavens (climbing man-made objects)
Shoten no jutsu- Tree climbing
Shoto  -  Short Sword
Shuki Ken  -  Elbow strike
Shuki Ken  - Hand Wake Up Fist
Shuko  -  Metal Claws for Hands
Shurikenjutsu – Blade Throwing
Shuto Ken - Sword hand strike
Soke - Grandmaster
Sokki Ken - Leg Wake Up Fist, knee strike
Soku Gyaku - Toe strike
Soku Yaku - Sole or heel strike
Sokugyaku Geri - Toe kick
Sokugyaku Ken - Foot Reverse Fist
Sokuho Geri - Sideways Kick
Sokuho Kaiten - Sideways Roll
Sokuho Tobi - Side leap
Sokuyaku Ken - Dancing Foot Fist
Sui -  Water
Sui Getsu  -  At the solar plexus in the chest
Sui Nage  -  Water Throw
Sui No Kata - Water Form
Sui Ren - Water training
Suiren jutsu - Water Training
Sukuho Geri - Side kick
Sutemi Nage -  Sacrificial throw
Suzu  -  Testicles
Tabi - Traditional Japanese footwear
Tachi Nagare  -  Standing Flow
Tachi Nage  -  Standing Throw
Tai Ken - Body Fist
Tai Sabaki - Body Evasion
Taihenjutsu - Body movement
Taihenjutsu - Body Skills
Taihodoki - Body Escape
Taijutsu - Unarmed/ Body skill
Taisabaki - Natural body movement
Taiso - Body conditioning
Take - Bamboo
Take Ori - Breaking Bamboo
Taki Otoshi  -  Cataract Drop (actually a category of throws)
Tanto  -  Knife
Tantojutsu - Knife fighting
Tatami -  Straw mat
Tate Nuki Uchi - Vertical Drawing Cut
Te - Hand
Tehodoki - Wrist Escapes
Teki - Enemy
Temakura  -  Hand Pillow
Tenchi no Kamae  -  Heaven and Earth Posture
Tenchijin no Kamae - Heaven, Earth, Man Posture (Rokushaku bo)
Tenmon  -  Bridge of the nose
Tenmon/Chimon – Meteorology/Geography
Tesson - Iron war fan
Tetsubushi - Metal caltrops
Toamijutsu - Fish net techniques
Tobi - Leap
Tobi Keri - Leap with a kick
Toki  - Top of foot
Tomoe Nage  -  Circle Throw
Tori - Person performing the attack
Torite Goho Gata - The Five Forms of Grappling
Tosui no Kamae - Water Ridge Posture
Totoku Hyoshi no Kamae - Sword Hiding Catapult Posture
Tsuba - Handguard of the katana 
Tsugi Bune - Collapsible boat
Tsuka - Handle of the katana
Tsuka Kishiri - Handle Endcap of the katana
Tsuki - Thrust
Uchi Gake  -  Great Striking Hook
Uchi Gata - Take down using legs
Uchi Mata  -  Inner Thigh Throw
Uke - person receiving the attack
Uke Nagashi - Receiving Flow
Uke Nagashi no Kamae - Flowing Block Posture
Ukemi - Breakfalls
Uko  -  Muscle at the side of the neck
Ura Gedan no Kamae - Outside Lower Level Posture
Ura Gyaku - Inward Reversal
Ura- Inside
Ura Kimon  -  Below the nipple
Ura Nage -  Reverse Throw
Ura Takeori - Inward Breaking Bamboo
Wakiboshi  -  Armpit
Wakizashi - Short sword
Waza - Techniques
Ya - Arrow
Yaku  -  Outside of shin
Yamabushi - Mountain warrior priest
Yame - Stop
Yari  -  Spear
Yoi - Ready
Yoko Aruki - Sideways Walking
Yoko Geri - Side kick
Yoko Nagare - Sideways Flow
Yoko Nagashi Zenpo Ukemi - Sideways Flowing Forward Breakfall
Yoko Seoi Nage  -  Sideways Shoulder Throw
Yoko Ukemi - Sideways Breakfall
Yokomen Uchi  - Strike to the Temples
Yoroi - Armor
Yubi - Finger
Yubitsubo  -  Ridge of Thumb Muscles
Yumi - Bow used with arrows
Zanshin - Awareness
Zenpo Geri - Forward Kick
Zenpo Kaiten- Front roll
Zenpo Kaiten Naname - Forward Diagonal Roll
Zenpo to Koho Kaiten - Forward to Backward Roll
Zenpo Tobi - Forward Leap
Zenpo Ukemi - Forward Breakfall





































































